111111111111
100000000001
10000E000001
100000000111
10000P0001P1
111111111111
