111111111111
1P00E0000001
100000000001
100000000001
100000000001
100000000001
100000000001
100000000001
111111111111
