111111111111
1C00P0000001
100000000001
100000000001
100000000001
100000000001
100000000001
100000000001
111111111111
