111111111111111111111111111111111
100000000000000000000000000000001
1000000000000XXXXXXX0000000000001
100E000000000XXXXXXX0000000000001
1000000000000XXXXXXX0000000000001
10000C0000C00XXXXXXX0P00000000001
1000000000000XXXXXXX0000000000001
1000000000000XXXXXXX0000000000001
1000000000000XXXXXXX0000000000001
1000000000000XXXXXXX0000000000001
1000000000000XXXXXXX0000000000001
1000000000000XXXXXXX0000000000001
1000000000000XXXXXXX0000000000001
1000000000000XXXXXXX0000000000001
1000000000000XXXXXXX0000000000001
1000000000000XXXXXXX0000000000001
1000000000000XXXXXXX0000000000001
1000000000000XXXXXXX0000000000001
1000000000000XXXXXXX0000000000001
1000000000000XXXXXXX0000000000001
1000000000000XXXXXXX0000000000001
1000000000000XXXXXXX0000000000001
1000000000000XXXXXXX0000000000001
1000000000000XXXXXXX0000000000001
1000000000000XXXXXXX0000000000001
1000000000000XXXXXXX0000000000001
1000000000000XXXXXXX0000000000001
1000000000000XXXXXXX0000000000001
1000000000000XXXXXXX0000000000001
1000000000000XXXXXXX0000000000001
1000000000000XXXXXXX0000000000001
1000000000000XXXXXXX0000000000001
100000000000000000000000000000001
111111111111111111111111111111111
