111111111111
1P0000000001
10111C011101
100000000001
10XXXXXXXX01
100000000001
101110C11101
100000000001
10XXXXXXXX01
1000000000E1
111111111111
