111111111111
100000000001
10000C000E01
100000000111
10000P000101
111111111111
