1111111111111111111111111111111111111
1PC0000000000000100000100000100000101
1C10111011101110101011111110111011101
1010001010001000101010001000100000101
1011111110111011101010111110111110101
1000100010101010001010100000100010001
1111101010101010111010111010111011101
1000001000001010001010000010000010101
1111101011111110111111111010111010101
1010001000000010000010001010101000001
1011101111111111111010111111101011101
1010001000000010100000001000000010001
1010101010111110101111101111101111101
1000100010000000000000100000001010101
1111101011111111111111111010111010111
1000101010000000000010000010000000001
1011111010101011101111111111101111111
1000000000101000100000001000100000001
1110101111111110101111111011101111111
1010101000001000100010000000100010001
1010101110111011111111111011111011101
1000100000001010001000000000000000001
1010101111101110111110111111101011101
1010101010101000000010000000101000101
1110111010101010101011101011101111101
1000100010001010101000101010001000001
1011111010111110111111101110111111101
1000100010000010001010001000001010001
1011101111101011101011101111101011111
1010100000101010100000001010100000001
1010111010101110111111111010101010111
1010001010000010000000100010001010001
1011101111101111101110101010111111111
1010000000101010001000101010000000001
1110101111101011111110111010111111101
10001000000000000010000000000010000E1
1111111111111111111111111111111111111
