11111111111111111
1P100010001000001
10101110111011101
10000010100010001
10111010111011101
10100000000010001
11101110111011101
10000010001010001
10111011111110111
10100010101000001
11101010101010101
10101000100010101
10111110111111111
10100010100010001
10111010101011101
10000000001000CE1
11111111111111111
