111111111111
100000000001
10000C000001
100000000111
10000P0001E1
111111111111
