111111111111
111111111111
11ECP1111111

110000111111
110000111111
110000111111
110000111111
111111111111
