11111111111111111
100000ECP1111
11111111111111111
