11111111111111111
1PX000X000X000001
10X0XXX0XXX0XXX01
100000X0X000X0001
10XXX0X0XXX0XXX01
10X000000000X0001
1XX0XXX0XXX0XXX01
100000X000X0X0001
10XXX0XXXXXXX0XX1
10X000X0X0X000001
1XX0X0X0X0X0X0X01
10X0X000X000X0X01
10XXXXX0XXXXXXXX1
10X000X0X000X0001
10XXX0X0X0X0XXX01
1000000000X000CE1
11111111111111111
